50
60
XXXXXXXXXXXXXXXXXXXXXXXXXXXXXXXXXXXXXXXXXXXXXXXXXX
X````````````````````````````````````````````````X
X````````````````````````````````````````````````X
X````````````````````````````````````````````````X
X````````````````````````````````````````````````X
X````````````````````````````````````````````````X
X````````````````````````````````````````````````X
X````````````````````````````````````````````````X
X````````````````````````````````````````````````X
X````````````````````````````````````````````````X
X````````````````````````````````````````````````X
X````````````````````````````````````````````````X
X````````````````````````````````````````````````X
X````````````````````````````````````````````````X
X````````````````````````````````````````````````X
X````````````````````````````````````````````````X
X````````````````````````````````````````````````X
X````````````````````````````````````````````````X
X````````````````````````````````````````````````X
X````````````````````````````````````````````````X
X````````````````````````````````````````````````X
X````````````````````````````````````````````````X
X````````````````````````````````````````````````X
X````````````````````````````````````````````````X
X````````````````````````````````````````````````X
X````````````````````````````````````````````````X
X````````````````````````````````````````````````X
X```````````````````````^````````````````````````X
X````````````````````````````````````````````````X
X````````````````````````````````````````````````X
X````````````````````````````````````````````````X
X````````````````````````````````````````````````X
X````````````````````````````````````````````````X
X````````````````````````````````````````````````X
X````````````````````````````````````````````````X
X````````````````````````````````````````````````X
X````````````````````````````````````````````````X
X````````````````````````````````````````````````X
X````````````````````````````````````````````````X
X````````````````````````````````````````````````X
X````````````````````````````````````````````````X
X````````````````````````````````````````````````X
X````````````````````````````````````````````````X
X````````````````````````````````````````````````X
X````````````````````````````````````````````````X
X````````````````````````````````````````````````X
X````````````````````````````````````````````````X
X````````````````````````````````````````````````X
X````````````````````````````````````````````````X
X````````````````````````````````````````````````X
X````````````````````````````````````````````````X
X````````````````````````````````````````````````X
X````````````````````````````````````````````````X
X````````````````````````````````````````````````X
X````````````````````````````````````````````````X
X````````````````````````````````````````````````X
X````````````````````````````````````````````````X
X````````````````````````````````````````````````X
X````````````````````````````````````````````````X
XXXXXXXXXXXXXXXXXXXXXXXXXXXXXXXXXXXXXXXXXXXXXXXXXX